=tartancols
=tartancols/tartan/
yellow=yellow
orange=orange
gold=gold
(lgt|light) orange=light-orange
anc(ient) red=ancient-red
anc(ient) white=ancient-white
coral=coral
yellow=yellow
rose=rose
anc(ient) yellow=ancient-yellow
orange=orange
basic red=basic-red
m(edium)? yellow=medium-yellow
scarlet old=scarlet-old
(lgt|light) crimson=light-crimson
red=red
scarlet=scarlet
terra cotta=terra-cotta
wilsons madder=wilsons-madder
(lgt|light) yellow=light-yellow
cerise=cerise
madder=madder
dark gold=dark-gold
dark orange=dark-orange
mauve=mauve
brick red=brick-red
alazarin=alazarin
crimson=crimson
faded green=faded-green
(lgt|light) brown=light-brown
rust=rust
sienna=sienna
yellow tan=yellow-tan
carmine=carmine
lindsay=lindsay
shale brown=shale-brown
marroon=marroon
khaki=khaki
gr[ae]y red=grey-red
dark red=dark-red
dark ruby=dark-ruby
wine red=wine-red
heather=heather
brown=brown
(lgt|light) umber=light-umber
olive brown=olive-brown
hunting brown=hunting-brown
drab=drab
umber=umber
dark umber=dark-umber
dark brown=dark-brown
parchment=parchment
(lgt|light) green=light-green
teal=teal
anc(ient) azure=ancient-azure
emerald=emerald
(weathered|wthrd) blue=weathered-blue
faded blue=faded-blue
(weathered|wthrd) green=weathered-green
verdant=verdant
anc(ient) green=ancient-green
green=green
olive green=olive-green
dark olive=dark-olive
green gr[ae]y=green-grey
hunting green=hunting-green
dark blue green=dark-blue-green
dark green=dark-green
carolina blue=carolina-blue
fs blue=fs-blue
(lgt|light) sky=light-sky
sky blue=sky-blue
purpleblue=purpleblue
(lgt|light) violet=light-violet
old blue=old-blue
(lgt|light) blue=light-blue
anderson blue=anderson-blue
balmoral blue=balmoral-blue
azure=azure
anc(ient) blue=ancient-blue
mauve=mauve
oxford=oxford
hsa blue=hsa-blue
blue=blue
purple=purple
royal blue=royal-blue
navy blue=navy-blue
blue gr[ae]y=blue-grey
dark blue=dark-blue
dark purple=dark-purple
midnight=midnight
clear=clear
wilson white=wilson-white
white=white
off white=off-white
(lgt|light) gr[ae]y=light-grey
gr[ae]y=grey
dark gr[ae]y=dark-grey
anc(ient) black=ancient-black
black=black
