
=whcols
=whcols/wh/
abaddon black=abaddon-black
administratum grey=administratum-grey
agrax earthshade=agrax-earthshade
agrellan earth=agrellan-earth
ahriman blue=ahriman-blue
alaitoc blue=alaitoc-blue
altdorf guard blue=altdorf-guard-blue
ardcoat=ardcoat
armageddon dust=armageddon-dust
astorath red=astorath-red
astrogranite=astrogranite
athonian camoshade=athonian-camoshade
auric armour gold=auric-armour-gold
averland sunset=averland-sunset
baharroth blue=baharroth-blue
balor brown=balor-brown
balthasar gold=balthasar-gold
baneblade brown=baneblade-brown
bestigor flesh=bestigor-flesh
biel tan green=biel-tan-green
blackfire earth=blackfire-earth
blood for the blood god=blood-for-the-blood-god
bloodletter=bloodletter
blue horror=blue-horror
brass scorpion=brass-scorpion
bugmans glow=bugmans-glow
cadian fleshtone=cadian-fleshtone
caledor sky=caledor-sky
calgar blue=calgar-blue
caliban green=caliban-green
carroburg crimson=carroburg-crimson
casandora yellow=casandora-yellow
castellan green=castellan-green
celestra grey=celestra-grey
ceramite white=ceramite-white
changeling pink=changeling-pink
chronus blue=chronus-blue
coelia greenshade=coelia-greenshade
daemonette hide=daemonette-hide
dark reaper=dark-reaper
dawnstone=dawnstone
dawnstone dry=dawnstone-dry
deathclaw brown=deathclaw-brown
death guard green=death-guard-green
deathworld forest=deathworld-forest
dechala lilac=dechala-lilac
doombull brown=doombull-brown
dorn yellow=dorn-yellow
drakenhof nightshade=drakenhof-nightshade
druchii violet=druchii-violet
dryad bark=dryad-bark
eldar flesh=eldar-flesh
elysian green=elysian-green
emperors children=emperors-children
eshin grey=eshin-grey
etherium blue=etherium-blue
evil sunz scarlet=evil-sunz-scarlet
fenrisian grey=fenrisian-grey
fire dragon bright=fire-dragon-bright
flash gitz yellow=flash-gitz-yellow
flayed one flesh=flayed-one-flesh
fuegan orange=fuegan-orange
fulgrim pink=fulgrim-pink
fulgurite copper=fulgurite-copper
gauss blaster green=gauss-blaster-green
gehennas gold=gehennas-gold
genestealer purple=genestealer-purple
golden griffon=golden-griffon
golgfag brown=golgfag-brown
gorthor brown=gorthor-brown
guilliman blue=guilliman-blue
hashut copper=hashut-copper
hellion green=hellion-green
hexos palesun=hexos-palesun
hoeth blue=hoeth-blue
hoeth blue dry=hoeth-blue-dry
imperial primer=imperial-primer
imrik blue=imrik-blue
incubi darkness=incubi-darkness
ironbreaker=ironbreaker
jokaero orange=jokaero-orange
kabalite green=kabalite-green
kantor blue=kantor-blue
karak stone=karak-stone
khorne red=khorne-red
kindleflame=kindleflame
kislev flesh=kislev-flesh
krieg khaki=krieg-khaki
lahmian medium=lahmian-medium
lamenters yellow=lamenters-yellow
leadbelcher=leadbelcher
liberator gold=liberator-gold
liquid green stuff=liquid-green-stuff
longbeard grey=longbeard-grey
loren forest=loren-forest
lothern blue=lothern-blue
lucius lilac=lucius-lilac
lugganath orange=lugganath-orange
lustrian undergrowth=lustrian-undergrowth
macragge blue=macragge-blue
martian ironearth=martian-ironearth
mechanicus standard grey=mechanicus-standard-grey
mephiston red=mephiston-red
moot green=moot-green
mournfang brown=mournfang-brown
mourn mountain snow=mourn-mountain-snow
naggaroth night=naggaroth-night
necron compound=necron-compound
niblet green=niblet-green
nihilakh oxide=nihilakh-oxide
nuln oil=nuln-oil
nurgles rot=nurgles-rot
nurgling green=nurgling-green
nurgling green dry=nurgling-green-dry
ogryn camo=ogryn-camo
pallid wych flesh=pallid-wych-flesh
pink horror=pink-horror
praxeti white=praxeti-white
rakarth flesh=rakarth-flesh
ratskin flesh=ratskin-flesh
reikland fleshshade=reikland-fleshshade
retributor armour=retributor-armour
rhinox hide=rhinox-hide
runefang steel=runefang-steel
runelord brass=runelord-brass
russ grey=russ-grey
ryza rust=ryza-rust
screamer pink=screamer-pink
screaming bell=screaming-bell
screaming skull=screaming-skull
seraphim sepia=seraphim-sepia
sigmarite=sigmarite
skarsnik green=skarsnik-green
skavenblight dinge=skavenblight-dinge
skink blue=skink-blue
skrag brown=skrag-brown
skullcrusher brass=skullcrusher-brass
slaanesh grey=slaanesh-grey
slaanesh grey dry=slaanesh-grey-dry
sotek green=sotek-green
soulstone blue=soulstone-blue
spiritstone red=spiritstone-red
squig orange=squig-orange
steel legion drab=steel-legion-drab
stegadon scale green=stegadon-scale-green
stirland mud=stirland-mud
stormfang=stormfang
stormhost silver=stormhost-silver
stormvermin fur=stormvermin-fur
straken green=straken-green
sybarite green=sybarite-green
sycorax bronze=sycorax-bronze
sylvaneth bark=sylvaneth-bark
tallarn sand=tallarn-sand
tau light ochre=tau-light-ochre
teclis blue=teclis-blue
temple guard blue=temple-guard-blue
terminatus stone=terminatus-stone
the fang grey=the-fang-grey
thousand sons blue=thousand-sons-blue
thunderhawk blue=thunderhawk-blue
thunderhawk blue dry=thunderhawk-blue-dry
troll slayer orange=troll-slayer-orange
tuskgor fur=tuskgor-fur
typhus corrosion=typhus-corrosion
tyrant skull=tyrant-skull
ulthuan grey=ulthuan-grey
underhive ash=underhive-ash
ungor flesh=ungor-flesh
ushabti bone=ushabti-bone
verminlord hide=verminlord-hide
waaagh flesh=waaagh-flesh
warboss green=warboss-green
warpfiend grey=warpfiend-grey
warplock bronze=warplock-bronze
warpstone glow=warpstone-glow
waystone green=waystone-green
waywatcher green=waywatcher-green
wazdakka red=wazdakka-red
white scar=white-scar
wild rider red=wild-rider-red
wrack white=wrack-white
xereus purple=xereus-purple
xv 88=xv-88
yriel yellow=yriel-yellow
zamesi desert=zamesi-desert
zandri dust=zandri-dust
