=webcols
=webcols/web/
web azure=web-azure
cyan=cyan
lime=lime
olive=olive
magenta=magenta
maroon=maroon
dark blue=dark-blue
light blue=light-blue
night=night
gunmetal=gunmetal
midnight=midnight
charcoal=charcoal
dark slate grey=dark-slate-grey
oil=oil
black cat=black-cat
iridium=iridium
black eel=black-eel
black cow=black-cow
gray wolf=gray-wolf
vampire gray=vampire-gray
gray dolphin=gray-dolphin
carbon gray=carbon-gray
ash gray=ash-gray
cloudy gray=cloudy-gray
smokey gray=smokey-gray
gray=gray
granite=granite
battleship gray=battleship-gray
gray cloud=gray-cloud
gray goose=gray-goose
platinum=platinum
metallic silver=metallic-silver
blue gray=blue-gray
light slate gray=light-slate-gray
slate gray=slate-gray
jet gray=jet-gray
mist blue=mist-blue
marble blue=marble-blue
slate blue=slate-blue
steel blue=steel-blue
blue jay=blue-jay
dark slate blue=dark-slate-blue
midnight blue=midnight-blue
navy blue=navy-blue
blue whale=blue-whale
lapis blue=lapis-blue
denim dark blue=denim-dark-blue
earth blue=earth-blue
cobalt blue=cobalt-blue
blueberry blue=blueberry-blue
sapphire blue=sapphire-blue
blue eyes=blue-eyes
royal blue=royal-blue
blue orchid=blue-orchid
blue lotus=blue-lotus
light slate blue=light-slate-blue
windows blue=windows-blue
glacial blue ice=glacial-blue-ice
silk blue=silk-blue
blue ivy=blue-ivy
blue koi=blue-koi
columbia blue=columbia-blue
baby blue=baby-blue
light steel blue=light-steel-blue
ocean blue=ocean-blue
blue ribbon=blue-ribbon
blue dress=blue-dress
dodger blue=dodger-blue
cornflower blue=cornflower-blue
sky blue=sky-blue
butterfly blue=butterfly-blue
iceberg=iceberg
crystal blue=crystal-blue
deep sky blue=deep-sky-blue
denim blue=denim-blue
light sky blue=light-sky-blue
day sky blue=day-sky-blue
jeans blue=jeans-blue
blue angel=blue-angel
pastel blue=pastel-blue
sea blue=sea-blue
powder blue=powder-blue
coral blue=coral-blue
light blue=light-blue
robin egg blue=robin-egg-blue
pale blue lily=pale-blue-lily
light cyan=light-cyan
water=water
aliceblue=aliceblue
light slate=light-slate
light aquamarine=light-aquamarine
electric blue=electric-blue
aquamarine=aquamarine
cyan=cyan
tron blue=tron-blue
blue zircon=blue-zircon
blue lagoon=blue-lagoon
celeste=celeste
blue diamond=blue-diamond
tiffany blue=tiffany-blue
cyan opaque=cyan-opaque
blue hosta=blue-hosta
northern lights blue=northern-lights-blue
medium turquoise=medium-turquoise
turquoise=turquoise
jellyfish=jellyfish
blue green=blue-green
macaw blue green=macaw-blue-green
light sea green=light-sea-green
dark turquoise=dark-turquoise
sea turtle green=sea-turtle-green
medium aquamarine=medium-aquamarine
greenish blue=greenish-blue
grayish turquoise=grayish-turquoise
beetle green=beetle-green
teal=teal
sea green=sea-green
camouflage green=camouflage-green
sage green=sage-green
hazel green=hazel-green
venom green=venom-green
fern green=fern-green
dark forest green=dark-forest-green
medium sea green=medium-sea-green
medium forest green=medium-forest-green
seaweed green=seaweed-green
pine green=pine-green
jungle green=jungle-green
shamrock green=shamrock-green
medium spring green=medium-spring-green
forest green=forest-green
green onion=green-onion
spring green=spring-green
lime green=lime-green
clover green=clover-green
rebecca purple=rebecca-purple
green snake=green-snake
alien green=alien-green
green apple=green-apple
yellow green=yellow-green
kelly green=kelly-green
zombie green=zombie-green
frog green=frog-green
green peas=green-peas
dollar bill green=dollar-bill-green
dark sea green=dark-sea-green
iguana green=iguana-green
avocado green=avocado-green
pistachio green=pistachio-green
salad green=salad-green
hummingbird green=hummingbird-green
nebula green=nebula-green
stoplight go green=stoplight-go-green
algae green=algae-green
jade green=jade-green
emerald green=emerald-green
lawn green=lawn-green
chartreuse=chartreuse
dragon green=dragon-green
mint green=mint-green
green thumb=green-thumb
light jade=light-jade
tea green=tea-green
green yellow=green-yellow
slime green=slime-green
goldenrod=goldenrod
harvest gold=harvest-gold
sun yellow=sun-yellow
corn yellow=corn-yellow
parchment=parchment
cream=cream
lemon chiffon=lemon-chiffon
cornsilk=cornsilk
beige=beige
blonde=blonde
antique white=antique-white
champagne=champagne
blanched almond=blanched-almond
vanilla=vanilla
tan brown=tan-brown
peach=peach
mustard=mustard
rubber ducky yellow=rubber-ducky-yellow
bright gold=bright-gold
golden brown=golden-brown
macaroni cheese=macaroni-cheese
saffron=saffron
beer=beer
cantaloupe=cantaloupe
bee yellow=bee-yellow
brown sugar=brown-sugar
burlywood=burlywood
deep peach=deep-peach
ginger brown=ginger-brown
school bus yellow=school-bus-yellow
sandy brown=sandy-brown
fall leaf brown=fall-leaf-brown
orange gold=orange-gold
sand=sand
cookie brown=cookie-brown
caramel=caramel
brass=brass
khaki=khaki
camel brown=camel-brown
bronze=bronze
tiger orange=tiger-orange
cinnamon=cinnamon
bullet shell=bullet-shell
dark goldenrod=dark-goldenrod
copper=copper
wood=wood
oak brown=oak-brown
moccasin=moccasin
army brown=army-brown
sandstone=sandstone
mocha=mocha
taupe=taupe
coffee=coffee
brown bear=brown-bear
red dirt=red-dirt
sepia=sepia
orange salmon=orange-salmon
rust=rust
red fox=red-fox
chocolate=chocolate
sedona=sedona
papaya orange=papaya-orange
halloween orange=halloween-orange
pumpkin orange=pumpkin-orange
construction cone orange=construction-cone-orange
sunrise orange=sunrise-orange
mango orange=mango-orange
dark orange=dark-orange
coral=coral
basket ball orange=basket-ball-orange
light salmon=light-salmon
tangerine=tangerine
dark salmon=dark-salmon
light coral=light-coral
bean red=bean-red
valentine red=valentine-red
shocking orange=shocking-orange
scarlet=scarlet
ruby red=ruby-red
ferrari red=ferrari-red
fire engine red=fire-engine-red
lava red=lava-red
love red=love-red
grapefruit=grapefruit
chestnut red=chestnut-red
cherry red=cherry-red
mahogany=mahogany
chilli pepper=chilli-pepper
cranberry=cranberry
red wine=red-wine
burgundy=burgundy
chestnut=chestnut
blood red=blood-red
sienna=sienna
sangria=sangria
firebrick=firebrick
maroon=maroon
plum pie=plum-pie
velvet maroon=velvet-maroon
plum velvet=plum-velvet
rosy finch=rosy-finch
puce=puce
dull purple=dull-purple
rosy brown=rosy-brown
khaki rose=khaki-rose
pink bow=pink-bow
lipstick pink=lipstick-pink
rose gold=rose-gold
desert sand=desert-sand
pig pink=pig-pink
cotton candy=cotton-candy
pink bubblegum=pink-bubblegum
misty rose=misty-rose
pink=pink
light pink=light-pink
flamingo pink=flamingo-pink
pink rose=pink-rose
pink daisy=pink-daisy
cadillac pink=cadillac-pink
blush red=blush-red
hot pink=hot-pink
watermelon pink=watermelon-pink
violet red=violet-red
deep pink=deep-pink
pink cupcake=pink-cupcake
pink lemonade=pink-lemonade
neon pink=neon-pink
magenta=magenta
dimorphotheca magenta=dimorphotheca-magenta
bright neon pink=bright-neon-pink
pale violet red=pale-violet-red
tulip pink=tulip-pink
medium violet red=medium-violet-red
rogue pink=rogue-pink
burnt pink=burnt-pink
bashful pink=bashful-pink
dark carnation pink=dark-carnation-pink
plum=plum
viola purple=viola-purple
purple iris=purple-iris
plum purple=plum-purple
indigo=indigo
purple monster=purple-monster
purple haze=purple-haze
eggplant=eggplant
grape=grape
purple jam=purple-jam
dark orchid=dark-orchid
purple flower=purple-flower
medium orchid=medium-orchid
purple amethyst=purple-amethyst
dark violet=dark-violet
violet=violet
purple sage bush=purple-sage-bush
lovely purple=lovely-purple
purple=purple
aztech purple=aztech-purple
medium purple=medium-purple
jasmine purple=jasmine-purple
purple daffodil=purple-daffodil
tyrian purple=tyrian-purple
crocus purple=crocus-purple
purple mimosa=purple-mimosa
heliotrope purple=heliotrope-purple
crimson=crimson
purple dragon=purple-dragon
lilac=lilac
blush pink=blush-pink
mauve=mauve
wisteria purple=wisteria-purple
blossom pink=blossom-pink
thistle=thistle
periwinkle=periwinkle
lavender pinocchio=lavender-pinocchio
lavender blue=lavender-blue
pearl=pearl
seashell=seashell
milk white=milk-white
white=white

